1, 1, 2, 3, 3, 3, 3, 3, 3, 3, 3, 3, 3, 3, 3, 4, 
1, 1, 2, 3, 3, 3, 3, 3, 3, 3, 3, 3, 3, 3, 3, 4, 
1, 1, 2, 3, 3, 3, 3, 3, 3, 3, 3, 3, 3, 3, 3, 4, 
1, 1, 2, 3, 3, 3, 3, 3, 3, 3, 3, 3, 3, 3, 3, 4, 
1, 1, 2, 3, 3, 3, 3, 3, 3, 3, 3, 3, 3, 3, 3, 4, 
1, 1, 2, 3, 3, 3, 3, 3, 3, 3, 3, 3, 3, 3, 3, 4, 
1, 1, 2, 3, 3, 3, 3, 3, 3, 3, 3, 3, 3, 3, 3, 4, 
1, 1, 1, 1, 1, 1, 1, 1, 1, 1, 1, 1, 1, 1, 1, 1
,
1, 1, 5, 6, 6, 6, 6, 6, 6, 6, 6, 6, 6, 6, 6, 6, 
1, 1, 5, 6, 6, 6, 6, 6, 6, 6, 6, 6, 6, 6, 6, 6, 
1, 1, 5, 6, 6, 6, 6, 6, 6, 6, 6, 6, 6, 6, 6, 6, 
1, 1, 5, 6, 6, 6, 6, 6, 6, 6, 6, 6, 6, 6, 6, 6, 
1, 1, 5, 6, 6, 6, 6, 6, 6, 6, 6, 6, 6, 6, 6, 6, 
1, 1, 5, 6, 6, 6, 6, 6, 6, 6, 6, 6, 6, 6, 6, 6, 
1, 1, 5, 6, 6, 6, 6, 6, 6, 6, 6, 6, 6, 6, 6, 6, 
1, 1, 1, 1, 1, 1, 1, 1, 1, 1, 1, 1, 1, 1, 1, 1
,
1, 1, 5, 7, 7, 7, 7, 7, 7, 7, 7, 7, 7, 7, 7, 7, 
1, 1, 5, 7, 7, 7, 7, 7, 7, 7, 7, 7, 7, 7, 7, 7, 
1, 1, 5, 7, 7, 7, 7, 7, 7, 7, 7, 7, 7, 7, 7, 7, 
1, 1, 5, 7, 7, 7, 7, 7, 7, 7, 7, 7, 7, 7, 7, 7, 
1, 1, 5, 7, 7, 7, 7, 7, 7, 7, 7, 7, 7, 7, 7, 7, 
1, 1, 5, 7, 7, 7, 7, 7, 7, 7, 7, 7, 7, 7, 7, 7, 
1, 1, 5, 7, 7, 7, 7, 7, 7, 7, 7, 7, 7, 7, 7, 7, 
1, 1, 1, 1, 1, 1, 1, 1, 1, 1, 1, 1, 1, 1, 1, 1
,
1, 1, 5, 6, 6, 6, 6, 6, 6, 6, 6, 6, 6, 6, 6, 6, 
1, 1, 5, 8, 8, 8, 8, 8, 8, 8, 8, 8, 8, 8, 8, 8, 
1, 1, 5, 9, 9, 9, 9, 9, 9, 9, 9, 9, 9, 9, 9, 9, 
1, 1, 5, 9, 9, 9, 9, 9, 9, 9, 9, 9, 9, 9, 9, 9, 
1, 1, 5, 8, 8, 8, 8, 8, 8, 8, 8, 8, 8, 8, 8, 8, 
1, 1, 5, 6, 6, 6, 6, 6, 6, 6, 6, 6, 6, 6, 6, 6, 
1, 1, 5, 8, 8, 8, 8, 8, 8, 8, 8, 8, 8, 8, 8, 8, 
1, 1, 10, 10, 1, 1, 1, 1, 1, 1, 1, 1, 10, 10, 1, 1
,
1, 1, 5, 7, 11, 7, 11, 7, 11, 7, 7, 12, 13, 12, 13, 7, 
1, 1, 5, 14, 14, 12, 13, 14, 12, 13, 14, 12, 13, 14, 11, 15, 
1, 1, 5, 16, 16, 11, 16, 16, 16, 16, 11, 16, 11, 16, 11, 16, 
1, 1, 5, 16, 16, 11, 16, 16, 16, 16, 11, 16, 11, 16, 11, 16, 
1, 1, 5, 14, 14, 12, 13, 14, 12, 13, 14, 12, 13, 14, 11, 15, 
1, 1, 5, 7, 11, 7, 11, 7, 11, 7, 7, 12, 13, 12, 13, 7, 
1, 1, 5, 14, 14, 12, 13, 14, 12, 13, 14, 12, 13, 14, 11, 15, 
1, 1, 17, 18, 1, 1, 1, 10, 1, 1, 1, 19, 17, 18, 1, 1
,
1, 1, 5, 7, 20, 7, 21, 7, 21, 7, 7, 22, 23, 22, 23, 7, 
1, 1, 5, 14, 14, 24, 25, 14, 24, 25, 14, 24, 25, 14, 26, 15, 
1, 10, 5, 16, 16, 26, 16, 27, 4, 16, 26, 16, 26, 16, 26, 16, 
1, 10, 5, 16, 16, 26, 16, 27, 4, 16, 26, 16, 26, 16, 26, 16, 
1, 1, 5, 14, 14, 24, 25, 14, 24, 25, 14, 24, 25, 14, 26, 15, 
1, 1, 5, 7, 20, 7, 21, 7, 21, 7, 7, 22, 23, 22, 23, 7, 
1, 1, 5, 14, 14, 24, 25, 14, 24, 25, 14, 24, 25, 14, 26, 15, 
1, 1, 28, 29, 1, 1, 10, 19, 30, 10, 1, 31, 28, 29, 10, 1
,
1, 1, 5, 7, 26, 7, 26, 7, 26, 7, 7, 24, 25, 24, 25, 7, 
1, 1, 5, 14, 14, 8, 8, 14, 8, 8, 20, 8, 8, 14, 8, 15, 
1, 17, 32, 16, 16, 9, 16, 9, 9, 16, 9, 16, 9, 16, 9, 16, 
1, 17, 32, 16, 16, 9, 16, 9, 9, 16, 9, 16, 9, 16, 9, 16, 
1, 1, 5, 14, 14, 8, 8, 14, 8, 8, 20, 8, 8, 14, 8, 15, 
1, 1, 5, 7, 26, 7, 26, 7, 26, 7, 7, 24, 25, 24, 25, 7, 
1, 1, 5, 14, 14, 8, 8, 14, 8, 8, 20, 8, 8, 14, 8, 15, 
1, 1, 28, 29, 1, 1, 17, 18, 33, 17, 1, 31, 19, 30, 30, 1
,
1, 1, 32, 27, 3, 4, 6, 7, 6, 7, 7, 6, 6, 6, 6, 7, 
10, 10, 32, 34, 34, 34, 34, 34, 34, 34, 34, 34, 34, 34, 34, 34, 
1, 28, 35, 34, 34, 34, 34, 34, 34, 34, 34, 34, 34, 34, 34, 34, 
1, 28, 35, 34, 34, 34, 34, 34, 34, 34, 34, 34, 34, 34, 34, 34, 
10, 10, 32, 34, 34, 34, 34, 34, 34, 34, 34, 34, 34, 34, 34, 34, 
1, 1, 32, 27, 3, 4, 6, 7, 6, 7, 7, 6, 6, 6, 6, 7, 
10, 10, 32, 34, 34, 34, 34, 34, 34, 34, 34, 34, 34, 34, 34, 34, 
36, 36, 36, 36, 36, 36, 36, 36, 36, 36, 36, 36, 36, 36, 36, 36
,
1, 1, 35, 34, 34, 34, 34, 34, 34, 34, 34, 34, 34, 34, 34, 34, 
19, 30, 35, 8, 8, 8, 37, 38, 39, 8, 8, 8, 8, 8, 8, 8, 
1, 28, 35, 9, 20, 9, 9, 9, 9, 9, 9, 9, 9, 9, 9, 9, 
1, 28, 35, 9, 20, 9, 9, 9, 9, 9, 9, 9, 9, 9, 9, 9, 
19, 30, 35, 8, 8, 8, 37, 38, 39, 8, 8, 8, 8, 8, 8, 8, 
1, 1, 35, 34, 34, 34, 34, 34, 34, 34, 34, 34, 34, 34, 34, 34, 
19, 30, 35, 8, 8, 8, 37, 38, 39, 8, 8, 8, 8, 8, 8, 8, 
40, 41, 40, 41, 40, 41, 40, 41, 40, 41, 40, 41, 40, 41, 40, 41
,
1, 1, 35, 6, 6, 6, 6, 6, 6, 6, 6, 6, 6, 6, 6, 6, 
31, 33, 35, 14, 11, 14, 12, 42, 13, 14, 11, 14, 11, 14, 11, 15, 
1, 28, 35, 16, 16, 16, 16, 16, 16, 16, 16, 16, 16, 16, 16, 16, 
1, 28, 35, 16, 16, 16, 16, 16, 16, 16, 16, 16, 16, 16, 16, 16, 
31, 33, 35, 14, 11, 14, 12, 42, 13, 14, 11, 14, 11, 14, 11, 15, 
1, 1, 35, 6, 6, 6, 6, 6, 6, 6, 6, 6, 6, 6, 6, 6, 
31, 33, 35, 14, 11, 14, 12, 42, 13, 14, 11, 14, 11, 14, 11, 15, 
41, 40, 41, 40, 41, 40, 41, 40, 41, 40, 41, 40, 41, 40, 40, 43
,
1, 1, 35, 7, 11, 7, 11, 7, 11, 7, 7, 12, 13, 12, 13, 7, 
31, 33, 35, 14, 21, 14, 22, 44, 23, 14, 21, 14, 21, 14, 21, 15, 
1, 28, 35, 16, 27, 4, 16, 16, 11, 16, 27, 3, 4, 16, 11, 16, 
1, 28, 35, 16, 27, 4, 16, 16, 11, 16, 27, 3, 4, 16, 11, 16, 
31, 33, 35, 14, 21, 14, 22, 44, 23, 14, 21, 14, 21, 14, 21, 15, 
1, 1, 35, 7, 11, 7, 11, 7, 11, 7, 7, 12, 13, 12, 13, 7, 
31, 33, 35, 14, 21, 14, 22, 44, 23, 14, 21, 14, 21, 14, 21, 15, 
34, 34, 34, 34, 34, 34, 34, 34, 34, 34, 34, 34, 34, 34, 40, 41
,
1, 1, 35, 7, 21, 7, 21, 7, 20, 7, 7, 22, 23, 22, 23, 7, 
31, 17, 35, 14, 26, 14, 22, 44, 23, 14, 26, 14, 26, 14, 26, 15, 
19, 28, 35, 16, 9, 9, 16, 16, 26, 16, 12, 42, 13, 16, 26, 16, 
19, 28, 35, 16, 9, 9, 16, 16, 26, 16, 12, 42, 13, 16, 26, 16, 
31, 17, 35, 14, 26, 14, 22, 44, 23, 14, 26, 14, 26, 14, 26, 15, 
1, 1, 35, 7, 21, 7, 21, 7, 20, 7, 7, 22, 23, 22, 23, 7, 
31, 17, 35, 14, 26, 14, 22, 44, 23, 14, 26, 14, 26, 14, 26, 15, 
45, 46, 45, 46, 45, 46, 45, 46, 45, 46, 45, 46, 45, 46, 40, 43
,
47, 47, 35, 7, 26, 7, 26, 7, 26, 7, 7, 24, 25, 24, 25, 7, 
31, 28, 35, 14, 20, 14, 24, 34, 25, 14, 8, 14, 8, 14, 8, 15, 
31, 28, 35, 16, 16, 16, 16, 16, 9, 16, 22, 44, 23, 16, 9, 16, 
31, 28, 35, 16, 16, 16, 16, 16, 9, 16, 22, 44, 23, 16, 9, 16, 
31, 28, 35, 14, 20, 14, 24, 34, 25, 14, 8, 14, 8, 14, 8, 15, 
47, 47, 35, 7, 26, 7, 26, 7, 26, 7, 7, 24, 25, 24, 25, 7, 
31, 28, 35, 14, 20, 14, 24, 34, 25, 14, 8, 14, 8, 14, 8, 15, 
45, 45, 45, 45, 45, 45, 45, 45, 45, 45, 45, 45, 45, 45, 40, 41
,
45, 45, 35, 7, 6, 7, 6, 7, 6, 7, 7, 6, 6, 6, 6, 7, 
31, 28, 35, 48, 48, 48, 49, 50, 51, 48, 48, 48, 48, 48, 48, 48, 
31, 28, 35, 48, 48, 48, 48, 48, 48, 48, 24, 34, 25, 48, 48, 48, 
31, 28, 35, 48, 48, 48, 48, 48, 48, 48, 24, 34, 25, 48, 48, 48, 
31, 28, 35, 48, 48, 48, 49, 50, 51, 48, 48, 48, 48, 48, 48, 48, 
45, 45, 35, 7, 6, 7, 6, 7, 6, 7, 7, 6, 6, 6, 6, 7, 
31, 28, 35, 48, 48, 48, 49, 50, 51, 48, 48, 48, 48, 48, 48, 48, 
45, 45, 45, 45, 45, 46, 45, 46, 45, 46, 45, 46, 45, 46, 40, 43
,
52, 52, 53, 52, 52, 52, 52, 52, 52, 52, 52, 52, 52, 52, 52, 52, 
52, 52, 53, 54, 54, 54, 49, 50, 51, 54, 54, 54, 54, 54, 54, 54, 
52, 52, 53, 54, 54, 54, 54, 54, 54, 54, 49, 50, 51, 54, 54, 54, 
52, 52, 53, 54, 54, 54, 54, 54, 54, 54, 49, 50, 51, 54, 54, 54, 
52, 52, 53, 54, 54, 54, 49, 50, 51, 54, 54, 54, 54, 54, 54, 54, 
52, 52, 53, 52, 52, 52, 52, 52, 52, 52, 52, 52, 52, 52, 52, 52, 
52, 52, 53, 54, 54, 54, 49, 50, 51, 54, 54, 54, 54, 54, 54, 54, 
36, 36, 36, 43, 55, 55, 55, 55, 55, 55, 55, 55, 55, 55, 40, 41
,
56, 56, 56, 56, 56, 57, 58, 59, 58, 59, 60, 56, 56, 56, 56, 56, 
56, 56, 56, 56, 56, 56, 56, 56, 56, 56, 56, 56, 56, 56, 56, 56, 
56, 56, 56, 56, 56, 56, 56, 56, 56, 56, 56, 56, 56, 56, 56, 56, 
56, 56, 56, 56, 56, 56, 56, 56, 56, 56, 56, 56, 56, 56, 56, 56, 
56, 56, 56, 56, 56, 56, 56, 56, 56, 56, 56, 56, 56, 56, 56, 56, 
56, 56, 56, 56, 56, 57, 58, 59, 58, 59, 60, 56, 56, 56, 56, 56, 
56, 56, 56, 56, 56, 56, 56, 56, 56, 56, 56, 56, 56, 56, 56, 56, 
40, 41, 40, 41, 61, 36, 43, 36, 36, 36, 36, 36, 36, 36, 40, 41
,
62, 62, 62, 62, 62, 62, 62, 62, 62, 62, 62, 62, 62, 62, 62, 62, 
62, 62, 62, 62, 62, 62, 62, 62, 62, 62, 62, 62, 62, 62, 62, 62, 
62, 62, 62, 62, 62, 62, 62, 62, 62, 62, 62, 62, 62, 62, 62, 62, 
62, 62, 62, 62, 62, 62, 62, 62, 62, 62, 62, 62, 62, 62, 62, 62, 
62, 62, 62, 62, 62, 62, 62, 62, 62, 62, 62, 62, 62, 62, 62, 62, 
62, 62, 62, 62, 62, 62, 62, 62, 62, 62, 62, 62, 62, 62, 62, 62, 
62, 62, 62, 62, 62, 62, 62, 62, 62, 62, 62, 62, 62, 62, 62, 62, 
41, 41, 63, 64, 41, 40, 41, 40, 41, 40, 41, 40, 41, 40, 40, 41
,
65, 65, 65, 65, 65, 65, 65, 65, 65, 65, 65, 65, 65, 65, 65, 65, 
65, 65, 65, 65, 65, 65, 65, 65, 65, 65, 65, 65, 65, 65, 65, 65, 
65, 65, 65, 65, 65, 65, 65, 65, 65, 65, 65, 65, 65, 65, 65, 65, 
65, 65, 65, 65, 65, 65, 65, 65, 65, 65, 65, 65, 65, 65, 65, 65, 
65, 65, 65, 65, 65, 65, 65, 65, 65, 65, 65, 65, 65, 65, 65, 65, 
65, 65, 65, 65, 65, 65, 65, 65, 65, 65, 65, 65, 65, 65, 65, 65, 
65, 65, 65, 65, 65, 65, 65, 65, 65, 65, 65, 65, 65, 65, 65, 65, 
40, 41, 40, 41, 40, 41, 40, 41, 40, 41, 40, 41, 40, 41, 41, 40
,
0, 0, 0, 0, 0, 0, 0, 0, 0, 0, 0, 0, 0, 0, 0, 0, 
0, 0, 0, 0, 0, 0, 0, 0, 0, 0, 0, 0, 0, 0, 0, 0, 
0, 0, 0, 0, 0, 0, 0, 0, 0, 0, 0, 0, 0, 0, 0, 0, 
0, 0, 0, 0, 0, 0, 0, 0, 0, 0, 0, 0, 0, 0, 0, 0, 
0, 0, 0, 0, 0, 0, 0, 0, 0, 0, 0, 0, 0, 0, 0, 0, 
0, 0, 0, 0, 0, 0, 0, 0, 0, 0, 0, 0, 0, 0, 0, 0, 
0, 0, 0, 0, 0, 0, 0, 0, 0, 0, 0, 0, 0, 0, 0, 0, 
0, 0, 0, 0, 0, 0, 0, 0, 0, 0, 0, 0, 0, 0, 0, 0
,
0, 0, 0, 0, 0, 0, 0, 0, 0, 0, 0, 0, 0, 0, 0, 0, 
0, 0, 0, 0, 0, 0, 0, 0, 0, 0, 0, 0, 0, 0, 0, 0, 
0, 0, 0, 0, 0, 0, 0, 0, 0, 0, 0, 0, 0, 0, 0, 0, 
0, 0, 0, 0, 0, 0, 0, 0, 0, 0, 0, 0, 0, 0, 0, 0, 
0, 0, 0, 0, 0, 0, 0, 0, 0, 0, 0, 0, 0, 0, 0, 0, 
0, 0, 0, 0, 0, 0, 0, 0, 0, 0, 0, 0, 0, 0, 0, 0, 
0, 0, 0, 0, 0, 0, 0, 0, 0, 0, 0, 0, 0, 0, 0, 0, 
0, 0, 0, 0, 0, 0, 0, 0, 0, 0, 0, 0, 0, 0, 0, 0
,
0, 0, 0, 0, 0, 0, 0, 0, 0, 0, 0, 0, 0, 0, 0, 0, 
0, 0, 0, 0, 0, 0, 0, 0, 0, 0, 0, 0, 0, 0, 0, 0, 
0, 0, 0, 0, 0, 0, 0, 0, 0, 0, 0, 0, 0, 0, 0, 0, 
0, 0, 0, 0, 0, 0, 0, 0, 0, 0, 0, 0, 0, 0, 0, 0, 
0, 0, 0, 0, 0, 0, 0, 0, 0, 0, 0, 0, 0, 0, 0, 0, 
0, 0, 0, 0, 0, 0, 0, 0, 0, 0, 0, 0, 0, 0, 0, 0, 
0, 0, 0, 0, 0, 0, 0, 0, 0, 0, 0, 0, 0, 0, 0, 0, 
0, 0, 0, 0, 0, 0, 0, 0, 0, 0, 0, 0, 0, 0, 0, 0
,
0, 0, 0, 0, 0, 0, 0, 0, 0, 0, 0, 0, 0, 0, 0, 0, 
0, 0, 0, 0, 0, 0, 0, 0, 0, 0, 0, 0, 0, 0, 0, 0, 
0, 0, 0, 0, 0, 0, 0, 0, 0, 0, 0, 0, 0, 0, 0, 0, 
0, 0, 0, 0, 0, 0, 0, 0, 0, 0, 0, 0, 0, 0, 0, 0, 
0, 0, 0, 0, 0, 0, 0, 0, 0, 0, 0, 0, 0, 0, 0, 0, 
0, 0, 0, 0, 0, 0, 0, 0, 0, 0, 0, 0, 0, 0, 0, 0, 
0, 0, 0, 0, 0, 0, 0, 0, 0, 0, 0, 0, 0, 0, 0, 0, 
0, 0, 0, 0, 0, 0, 0, 0, 0, 0, 0, 0, 0, 0, 0, 0
,
0, 0, 0, 0, 0, 0, 0, 0, 0, 0, 0, 0, 0, 0, 0, 0, 
0, 0, 0, 0, 0, 0, 0, 0, 0, 0, 0, 0, 0, 0, 0, 0, 
0, 0, 0, 0, 0, 0, 0, 0, 0, 0, 0, 0, 0, 0, 0, 0, 
0, 0, 0, 0, 0, 0, 0, 0, 0, 0, 0, 0, 0, 0, 0, 0, 
0, 0, 0, 0, 0, 0, 0, 0, 0, 0, 0, 0, 0, 0, 0, 0, 
0, 0, 0, 0, 0, 0, 0, 0, 0, 0, 0, 0, 0, 0, 0, 0, 
0, 0, 0, 0, 0, 0, 0, 0, 0, 0, 0, 0, 0, 0, 0, 0, 
0, 0, 0, 0, 0, 0, 0, 0, 0, 0, 0, 0, 0, 0, 0, 0
,
0, 0, 0, 0, 0, 0, 0, 0, 0, 0, 0, 0, 0, 0, 0, 0, 
0, 0, 0, 0, 0, 0, 0, 0, 0, 0, 0, 0, 0, 0, 0, 0, 
0, 0, 0, 0, 0, 0, 0, 0, 0, 0, 0, 0, 0, 0, 0, 0, 
0, 0, 0, 0, 0, 0, 0, 0, 0, 0, 0, 0, 0, 0, 0, 0, 
0, 0, 0, 0, 0, 0, 0, 0, 0, 0, 0, 0, 0, 0, 0, 0, 
0, 0, 0, 0, 0, 0, 0, 0, 0, 0, 0, 0, 0, 0, 0, 0, 
0, 0, 0, 0, 0, 0, 0, 0, 0, 0, 0, 0, 0, 0, 0, 0, 
0, 0, 0, 0, 0, 0, 0, 0, 0, 0, 0, 0, 0, 0, 0, 0
,
0, 0, 0, 0, 0, 0, 0, 0, 0, 0, 0, 0, 0, 0, 0, 0, 
0, 0, 0, 0, 0, 0, 0, 0, 0, 0, 0, 0, 0, 0, 0, 0, 
0, 0, 0, 0, 0, 0, 0, 0, 0, 0, 0, 0, 0, 0, 0, 0, 
0, 0, 0, 0, 0, 0, 0, 0, 0, 0, 0, 0, 0, 0, 0, 0, 
0, 0, 0, 0, 0, 0, 0, 0, 0, 0, 0, 0, 0, 0, 0, 0, 
0, 0, 0, 0, 0, 0, 0, 0, 0, 0, 0, 0, 0, 0, 0, 0, 
0, 0, 0, 0, 0, 0, 0, 0, 0, 0, 0, 0, 0, 0, 0, 0, 
0, 0, 0, 0, 0, 0, 0, 0, 0, 0, 0, 0, 0, 0, 0, 0
,
0, 0, 0, 0, 0, 0, 0, 0, 0, 0, 0, 0, 0, 0, 0, 0, 
0, 0, 0, 0, 0, 0, 0, 0, 0, 0, 0, 0, 0, 0, 0, 0, 
0, 0, 0, 0, 0, 0, 0, 0, 0, 0, 0, 0, 0, 0, 0, 0, 
0, 0, 0, 0, 0, 0, 0, 0, 0, 0, 0, 0, 0, 0, 0, 0, 
0, 0, 0, 0, 0, 0, 0, 0, 0, 0, 0, 0, 0, 0, 0, 0, 
0, 0, 0, 0, 0, 0, 0, 0, 0, 0, 0, 0, 0, 0, 0, 0, 
0, 0, 0, 0, 0, 0, 0, 0, 0, 0, 0, 0, 0, 0, 0, 0, 
0, 0, 0, 0, 0, 0, 0, 0, 0, 0, 0, 0, 0, 0, 0, 0
,
0, 0, 0, 0, 0, 0, 0, 0, 0, 0, 0, 0, 0, 0, 0, 0, 
0, 0, 0, 0, 0, 0, 0, 0, 0, 0, 0, 0, 0, 0, 0, 0, 
0, 0, 0, 0, 0, 0, 0, 0, 0, 0, 0, 0, 0, 0, 0, 0, 
0, 0, 0, 0, 0, 0, 0, 0, 0, 0, 0, 0, 0, 0, 0, 0, 
0, 0, 0, 0, 0, 0, 0, 0, 0, 0, 0, 0, 0, 0, 0, 0, 
0, 0, 0, 0, 0, 0, 0, 0, 0, 0, 0, 0, 0, 0, 0, 0, 
0, 0, 0, 0, 0, 0, 0, 0, 0, 0, 0, 0, 0, 0, 0, 0, 
0, 0, 0, 0, 0, 0, 0, 0, 0, 0, 0, 0, 0, 0, 0, 0
,
0, 0, 0, 0, 0, 0, 0, 0, 0, 0, 0, 0, 0, 0, 0, 0, 
0, 0, 0, 0, 0, 0, 0, 0, 0, 0, 0, 0, 0, 0, 0, 0, 
0, 0, 0, 0, 0, 0, 0, 0, 0, 0, 0, 0, 0, 0, 0, 0, 
0, 0, 0, 0, 0, 0, 0, 0, 0, 0, 0, 0, 0, 0, 0, 0, 
0, 0, 0, 0, 0, 0, 0, 0, 0, 0, 0, 0, 0, 0, 0, 0, 
0, 0, 0, 0, 0, 0, 0, 0, 0, 0, 0, 0, 0, 0, 0, 0, 
0, 0, 0, 0, 0, 0, 0, 0, 0, 0, 0, 0, 0, 0, 0, 0, 
0, 0, 0, 0, 0, 0, 0, 0, 0, 0, 0, 0, 0, 0, 0, 0
