1 -32.0 240.0 0 1 -1
1 0.0 192.0 0 1 -1
1 16.0 192.0 0 1 -1
1 32.0 192.0 0 1 -1
1 48.0 192.0 0 1 -1
1 62.0 208.0 0 1 -1
1 78.0 208.0 0 1 -1
1 175.0 208.0 0 1 -1
1 191.0 208.0 0 1 -1
1 208.0 192.0 0 1 -1
1 224.0 192.0 0 1 -1
1 256.0 160.0 0 1 -1
1 272.0 160.0 0 1 -1
1 288.0 160.0 0 1 -1
1 304.0 160.0 0 1 -1
1 119.0 320.0 0 1 -1
1 135.0 320.0 0 1 -1
1 0.0 912.0 0 1 -1
1 16.0 912.0 0 1 -1
1 32.0 912.0 0 1 -1
1 48.0 912.0 0 1 -1
1 64.0 912.0 0 1 -1
1 80.0 912.0 0 1 -1
1 96.0 912.0 0 1 -1
1 128.0 912.0 0 1 -1
1 160.0 912.0 0 1 -1
1 192.0 912.0 0 1 -1
1 224.0 912.0 0 1 -1
1 256.0 912.0 0 1 -1
1 288.0 912.0 0 1 -1
1 320.0 912.0 0 1 -1
1 336.0 912.0 0 1 -1
1 352.0 912.0 0 1 -1
1 384.0 912.0 0 1 -1
1 416.0 912.0 0 1 -1
1 440.0 912.0 0 1 -1
1 458.0 912.0 0 1 -1
1 490.0 912.0 0 1 -1
1 522.0 912.0 0 1 -1
1 554.0 912.0 0 1 -1
1 586.0 912.0 0 1 -1
1 618.0 912.0 0 1 -1
1 650.0 912.0 0 1 -1
1 682.0 912.0 0 1 -1
1 714.0 912.0 0 1 -1
1 746.0 912.0 0 1 -1
1 778.0 912.0 0 1 -1
1 784.0 912.0 0 1 -1
1 720.0 832.0 0 1 -1
1 736.0 832.0 0 1 -1
1 752.0 832.0 0 1 -1
1 800.0 816.0 0 1 -1
1 800.0 912.0 0 1 -1
1 830.0 912.0 0 1 -1
1 862.0 912.0 0 1 -1
1 894.0 912.0 0 1 -1
1 926.0 912.0 0 1 -1
1 958.0 912.0 0 1 -1
1 990.0 912.0 0 1 -1
