0 160.0 200.0 0 1 -1
1 -32.0 240.0 0 1 -1
1 0.0 240.0 0 1 -1
1 16.0 240.0 0 1 -1
1 32.0 240.0 0 1 -1
1 48.0 240.0 0 1 -1
1 64.0 240.0 0 1 -1
1 96.0 240.0 0 1 -1
1 128.0 240.0 0 1 -1
1 160.0 240.0 0 1 -1
1 192.0 240.0 0 1 -1
1 224.0 240.0 0 1 -1
1 256.0 240.0 0 1 -1
2 100.0 200.0 0 1 -1
3 50.0 200.0 0 1 -1