1 -32.0 176.0 0 1 -1
1 -16.0 208.0 0 1 -1
1 0.0 208.0 0 1 -1
1 16.0 208.0 0 1 -1
1 32.0 208.0 0 1 -1
1 48.0 208.0 0 1 -1
1 64.0 208.0 0 1 -1
1 80.0 208.0 0 1 -1
1 96.0 208.0 0 1 -1
1 112.0 208.0 0 1 -1
1 128.0 208.0 0 1 -1
1 144.0 208.0 0 1 -1
1 160.0 208.0 0 1 -1
1 176.0 208.0 0 1 -1
1 192.0 208.0 0 1 -1
1 208.0 208.0 0 1 -1
1 224.0 208.0 0 1 -1
1 240.0 208.0 0 1 -1
1 256.0 208.0 0 1 -1
1 272.0 208.0 0 1 -1
1 256.0 176.0 0 1 -1
7 200.0 20.0 3 1 -1