1 0.0 208.0 0 1 -1
1 16.0 208.0 0 1 -1
1 32.0 208.0 0 1 -1
1 48.0 208.0 0 1 -1
1 64.0 208.0 0 1 -1
1 96.0 208.0 0 1 -1
1 128.0 208.0 0 1 -1
1 160.0 208.0 0 1 -1
1 192.0 208.0 0 1 -1
1 224.0 208.0 0 1 -1
1 256.0 208.0 0 1 -1
1 48.0 112.0 0 1 -1
1 80.0 112.0 0 1 -1
6 208.0 0.0 0 1 -1