1 0.0 240.0 0 1 -1
1 16.0 240.0 0 1 -1
1 32.0 240.0 0 1 -1
1 48.0 240.0 0 1 -1
1 64.0 240.0 0 1 -1
1 96.0 240.0 0 1 -1
1 128.0 240.0 0 1 -1
1 48.0 112.0 0 1 -1
1 64.0 112.0 0 1 -1
1 80.0 112.0 0 1 -1
4 128.0 108.0 0 1 1
4 100.0 50.0 0 1 0