0 160.0 200.0 0 1 -1
0 448.0 200.0 0 1 -1
0 672.0 200.0 0 1 -1
0 960.0 200.0 0 1 -1
0 1216.0 200.0 0 1 1
1 -32.0 240.0 0 1 -1
1 -32.0 272.0 0 1 -1
1 -32.0 304.0 0 1 -1
1 -32.0 336.0 0 1 -1
1 -32.0 368.0 0 1 -1
1 0.0 240.0 0 1 -1
1 16.0 240.0 0 1 -1
1 32.0 240.0 0 1 -1
1 48.0 240.0 0 1 -1
1 64.0 240.0 0 1 -1
1 96.0 240.0 0 1 -1
1 128.0 240.0 0 1 -1
1 160.0 240.0 0 1 -1
1 192.0 240.0 0 1 -1
1 224.0 240.0 0 1 -1
1 256.0 240.0 0 1 -1
1 288.0 240.0 0 1 -1
1 320.0 240.0 0 1 -1
1 352.0 240.0 0 1 -1
1 384.0 240.0 0 1 -1
1 416.0 240.0 0 1 -1
1 448.0 240.0 0 1 -1
1 480.0 240.0 0 1 -1
1 512.0 240.0 0 1 -1
1 544.0 240.0 0 1 -1
1 576.0 240.0 0 1 -1
1 608.0 240.0 0 1 -1
1 640.0 240.0 0 1 -1
1 672.0 240.0 0 1 -1
1 704.0 240.0 0 1 -1
1 736.0 240.0 0 1 -1
1 768.0 240.0 0 1 -1
1 800.0 240.0 0 1 -1
1 832.0 240.0 0 1 -1
1 864.0 240.0 0 1 -1
1 896.0 240.0 0 1 -1
1 928.0 240.0 0 1 -1
1 960.0 240.0 0 1 -1
1 992.0 240.0 0 1 -1
1 1024.0 240.0 0 1 -1
1 1056.0 240.0 0 1 -1
1 1088.0 240.0 0 1 -1
1 1120.0 240.0 0 1 -1
1 1152.0 240.0 0 1 -1
1 1184.0 240.0 0 1 -1
1 1216.0 240.0 0 1 -1
1 1248.0 240.0 0 1 -1
1 1280.0 240.0 0 1 -1
1 1312.0 240.0 0 1 -1
1 1344.0 240.0 0 1 -1
1 1376.0 240.0 0 1 -1
1 1408.0 240.0 0 1 -1
1 1440.0 240.0 0 1 -1
1 1472.0 240.0 0 1 -1
1 1504.0 240.0 0 1 -1
1 1536.0 240.0 0 1 -1
1 1568.0 240.0 0 1 -1
1 1600.0 240.0 0 1 -1
1 1632.0 240.0 0 1 -1
1 1664.0 240.0 0 1 -1
1 1696.0 240.0 0 1 -1
1 1728.0 240.0 0 1 -1
1 1760.0 240.0 0 1 -1
1 1792.0 240.0 0 1 -1
1 1824.0 240.0 0 1 -1
1 1856.0 240.0 0 1 -1
1 1888.0 240.0 0 1 -1
1 1920.0 240.0 0 1 -1
1 1952.0 240.0 0 1 -1
1 1984.0 240.0 0 1 -1
1 1792.0 225.0 0 1 -1
1 1834.0 225.0 0 1 -1
1 48.0 112.0 0 1 -1
1 64.0 112.0 0 1 -1
1 80.0 112.0 0 1 -1
1 576.0 160.0 0 1 -1
1 592.0 160.0 0 1 -1
1 672.0 160.0 0 1 -1
1 688.0 160.0 0 1 -1
1 704.0 160.0 0 1 -1
1 832.0 160.0 0 1 -1
1 848.0 160.0 0 1 -1
1 928.0 160.0 0 1 -1
1 944.0 160.0 0 1 -1
1 960.0 160.0 0 1 -1
1 624.0 80.0 0 1 -1
1 640.0 80.0 0 1 -1
1 880.0 80.0 0 1 -1
1 896.0 80.0 0 1 -1
2 900.0 200.0 0 1 0
3 400.0 200.0 0 1 -1
4 128.0 178.0 0 1 1
4 321.0 193.0 0 1 0